#Stage3-5,,,,,,,,,,,,,,,,
0,0,0,0,0,0,0,0,3,0,7,0,0,0,0,0,0
0,0,0,0,0,0,0,0,0,0,0,0,0,0,0,0,0
5,0,0,304,0,0,204,0,0,0,0,0,0,1,0,0,0
0,0,0,0,0,114,0,0,0,0,0,0,0,0,0,0,0
0,0,0,0,0,0,0,0,0,0,0,0,0,0,0,0,13
0,0,203,0,0,0,0,0,0,0,0,0,0,0,0,0,0
4,0,0,0,0,0,0,0,0,205,0,0,0,9,0,0,4
0,0,0,0,0,0,300,0,0,0,0,0,0,0,0,0,0
0,0,0,0,0,0,0,9,0,0,0,0,0,0,107,0,0
12,0,100,0,0,0,0,0,0,0,0,0,0,0,0,0,6
0,204,0,0,0,0,0,0,0,0,0,0,0,0,0,0,0
0,0,0,100,0,0,0,0,0,0,0,0,0,0,0,0,0
0,0,0,0,0,8,0,0,3,0,0,0,0,0,0,0,0
