#Stage1-5,,,,,,,,,,,,,,,,
2,2,2,2,2,2,2,2,2,2,2,2,2,2,2,2,2
2,205,0,0,0,0,0,0,0,0,200,0,0,0,0,205,2
2,0,0,0,0,0,0,0,0,0,0,0,0,0,0,100,2
2,0,100,0,0,0,0,0,0,0,0,0,0,0,0,0,2
2,0,0,0,0,0,0,0,0,0,0,0,201,0,0,0,2
2,0,0,0,304,0,0,0,0,0,0,0,0,0,0,0,2
2,0,0,0,0,0,0,0,0,0,0,0,0,0,0,0,2
2,0,0,204,0,0,302,0,0,0,0,0,0,0,0,0,2
2,0,0,0,0,0,0,0,0,0,0,0,0,0,0,0,2
2,0,0,0,0,0,0,0,0,0,0,0,302,0,0,0,2
2,0,0,0,0,0,0,0,1,0,0,0,0,0,0,202,2
2,0,0,0,0,0,100,0,0,0,0,0,0,0,0,0,2
2,2,2,2,2,2,2,2,2,2,2,2,2,2,2,2,2
