#Stage1-3,,,,,,,,,,,,,,,,
2,2,2,2,2,2,2,2,2,2,2,2,2,2,2,2,2
2,0,100,0,0,0,0,0,0,0,0,0,0,0,0,0,2
2,0,0,0,0,0,303,0,0,0,0,0,204,0,0,100,2
2,0,204,0,0,0,0,0,0,0,0,0,0,0,0,0,2
2,0,0,0,0,0,0,0,0,0,0,0,0,0,0,0,2
2,0,0,0,0,0,0,0,0,0,304,0,0,0,0,0,2
2,0,0,0,0,0,0,0,0,0,0,0,0,0,0,0,2
2,0,0,300,0,0,0,0,0,0,0,0,0,0,0,0,2
2,0,0,0,0,0,0,1,0,0,0,0,0,0,0,0,2
2,0,0,0,0,0,0,0,204,0,0,0,0,0,0,0,2
2,0,0,0,0,0,0,0,0,0,0,0,0,0,0,0,2
2,0,0,0,0,0,0,0,0,0,0,100,0,0,0,0,2
2,2,2,2,2,2,2,2,2,2,2,2,2,2,2,2,2
